1111111111
1C010001E1
1000010101
1011110101
1000P10001
1111111111