111111111111
10000001C101
101101P10001
100101110101
110101000101
1000000101E1
111111111111
