111111111111
100000010101
101101P10001
100101110101
110101000101
1C00L00101E1
111111111111
