111111111111
100000010101
101101010001
100101110101
110101000101
1C00000101E1
111111111111
