111111111111
100000010101
101101010001
100101110101
11010100P101
1C000001P1E1
111111111111
