111111111101
100000010101
101101P10001
100101110101
110101001001
1C00000101E1
111111111111
