111111111111
100000010101
101101P10001
100101110101
110101001000
1C00000101E1
111111111111
