111111111111
100000010101
101101P10001
100101110101
11010100101
1C00000101E1
111111111111
