11111111111111111
1P1E00000001C0001
10111111110101101
10000000010000001
11111101011111101
10000001000000001
11111111111111111